{
    "1": [
      [ 0, 1, 1, 0, 1, 1, 0, 1, 1, 0 ]
    ],
    "2": [
      [ 1, 0, 0, 0, 0, 0, 0, 0, 0, 1 ],
      [ 0, 1, 0, 0, 0, 0, 0, 0, 1, 0 ],
      [ 0, 0, 1, 0, 0, 0, 0, 1, 0, 0 ],
      [ 0, 0, 0, 1, 0, 0, 1, 0, 0, 0 ],
      [ 0, 0, 0, 0, 0, 0, 0, 0, 0, 0 ],
      [ 0, 0, 0, 0, 1, 1, 0, 0, 0, 0 ],
      [ 0, 0, 0, 1, 0, 0, 1, 0, 0, 0 ],
      [ 0, 0, 1, 0, 0, 0, 0, 1, 0, 0 ],
      [ 0, 1, 0, 0, 0, 0, 0, 0, 1, 0 ],
      [ 1, 0, 0, 0, 0, 0, 0, 0, 0, 1 ]
    ],
    "3": [
      [ 4, 4, 4, 4, 4, 4, 4, 4, 4, 4 ],
      [ 2, 0, 0, 0, 0, 0, 0, 0, 0, 2 ],
      [ 2, 0, 0, 0, 0, 0, 0, 0, 0, 2 ],
      [ 2, 0, 0, 0, 0, 0, 0, 0, 0, 2 ],
      [ 2, 0, 0, 0, 0, 0, 0, 0, 0, 2 ],
      [ 2, 0, 0, 0, 0, 0, 0, 0, 0, 2 ],
      [ 2, 0, 0, 0, 0, 0, 0, 0, 0, 2 ],
      [ 2, 0, 0, 0, 6, 6, 0, 0, 0, 2 ],
      [ 2, 0, 0, 0, 6, 6, 0, 0, 0, 2 ],
      [ 4, 4, 4, 4, 6, 6, 4, 4, 4, 4 ]
    ],
    "4": [
      [ 0, 6, 6, 0, 0, 0, 6, 6, 0, 0 ],
      [ 0, 6, 0, 6, 0, 6, 0, 0, 6, 0 ],
      [ 0, 6, 0, 6, 0, 6, 0, 0, 6, 0 ],
      [ 0, 6, 6, 0, 0, 6, 0, 0, 6, 0 ],
      [ 0, 6, 0, 0, 0, 6, 0, 0, 6, 0 ],
      [ 0, 6, 0, 0, 0, 0, 6, 6, 0, 0 ],
      [ 0, 0, 0, 0, 0, 0, 0, 0, 0, 0 ],
      [ 0, 1, 1, 1, 1, 1, 1, 1, 1, 0 ]
    ],
    "5": [
      [ 1, 3, 1, 3, 1, 3, 1, 3, 1, 3 ],
      [ 3, 1, 3, 1, 3, 1, 3, 1, 3, 1 ],
      [ 1, 3, 1, 3, 1, 3, 1, 3, 1, 3 ]
    ]
  }
